111111111111111111111111111111
111111111111111111111111111111
11            11            11
11 1  1 11 11 11 11 11 1  1 11
11B1  1 1   1 11 1   1 1  1B11
11 1111 11 11 11 11 11 1111 11
11                          11
11 1111 11 11111111 11 1111 11
11 1111 11 11111111 11 1111 11
11      11    11    11      11
1111111 11111 11 11111 1111111
1     1 11111 11 11111 1     1
1       11r o    s p11       1
1     1 11 11111111 11 1     1
1111111 11 1      1 11 1111111
           -      -           
1111111 11 1      1 11 1111111
1     1 11 11111111 11 1     1
1       11          11       1
1     1 11 11111111 11 1     1
1111111 11 11111111 11 1111111
11            11            11
11 1111 11111 11 11111 1111 11
11 1111 11111 11 11111 1111 11
11B  11                11  B11
1111 11 11 11111111 11 11 1111
1111 11 11 11111111 11 11 1111
11      11    11 P  11      11
11 1111111111 11 1111111111 11
11 1111111111 11 1111111111 11
11                          11
111111111111111111111111111111
111111111111111111111111111111
